1111111111111
10010000001C1
1001000000101
10010000000C1
10010000000C1
10010000000C1
100100P0E0001
1001000000C01
10010000000C1        
1001000000011         
1000011111111               
1000110000011         
1111111111111
1111111111111               
1111111111111               
1111111111111               
1111111111111               
1111111111111